########################################
#......................................#
#......................................#
#......##..................##..........#
#......##..................##..........#
#......................................#
#......................................#
#..................##..................#
#..................##..................#
#......................................#
#......................................#
#......##..................##..........#
#......##..................##..........#
#......................................#
#......................................#
#..................##..................#
#..................##..................#
#......................................#
#......................................#
########################################
