############################################################
#..........................................................#
#...............########...............########............#
#...............#......#...............#......#............#
#...............#......#...............#......#............#
#...............########...............########............#
#..........................................................#
#..........##########...........##########.................#
#..........#........#...........#........#.................#
#..........#........#...........#........#.................#
#..........##########...........##########.................#
#..........................................................#
#....................######.....######.....................#
#....................#....#.....#....#.....................#
#....................#....#.....#....#.....................#
#....................######.....######.....................#
#..........................................................#
#..........##########...........##########.................#
#..........#........#...........#........#.................#
#..........#........#...........#........#.................#
#..........##########...........##########.................#
#..........................................................#
#...............########...............########............#
#...............#......#...............#......#............#
#...............########...............########............#
############################################################
